#######################
#########.^..##########
#########....##########
#########.@..##########
#########....##########
########......#########
########......#########
########......#########
########......#########
###........X........###
##........X..........##
#.........X..........##
#..........X.........##
##........X.........###
#####......V......#####
#######################