#######################
#................@..^##
#....X.....X....#######
#...............#...###
####...X............###
#..................####
#......#####......#.###
#......#..##....###..##
#####....###....#....##
#######..###....###.###
#........###........###
#..#######.########.###
#..#..........#####.###
#..#..############..###
#.....####...V###...###
#...########.#####..###
#...##........####..###
#...##..##########..###
#............#####..###
#...##..#######.....###
#..###..#######....####
#.........###....######
#######...........#####
#######################