######################
#......^.........@...#
#....................#
#....................#
#....................#
#....................#
#....................#
#....................#
#....................#
#....................#
#....................#
#........V...........#
#....................#
#....................#
#....................#
#....................#
#....................#
#....................#
#....................#
#....................#
#....................#
#....................#
######################
######################