#######################
#....P..^..P.....P...##
#.................X..##
#....................##
#..........@.........##
#....X...............##
#....................##
#.........X..........##
#................X...##
#..........V.........##
#######################