#########################
##@...^########....######
##....................###
#............X..X.X...###
#...........X....X....###
#..........X.....X....###
###........X..V.X....####
#..........X...X.....####
#...........X.X.......###
##....................###
####.................####
#########################